5 5 5 5 5 5 5 5 5 5 5 5 5 5 5 3 2 1
5 5 5 5 5 5 5 5 5 5 5 5 5 5 5 3 2 2
4 4 4 4 4 0 0 0 0 0 4 4 4 4 4 2 2 3
4 1 4 1 4 0 0 1 0 0 4 1 4 1 4 1 2 4
3 3 3 3 3 0 0 0 0 0 3 3 3 3 3 2 0 5
3 3 1 3 3 3 3 3 3 3 3 3 1 3 3 5 0 1
2 2 2 2 2 2 2 2 2 2 2 2 2 2 2 5 0 2
2 2 2 2 1 1 1 2 2 2 2 2 2 2 2 5 4 4